TTTTTTTTTTTTTTTTTTTTTT
T@ TTTT####TTTTTTTTTTT
T   ##### #TTBBBTTTTTT
T B #######TTTTTTTTTTT
T   ##  TT#TTTTTTBTTTT
T B ###B T#TTTCTTTTTTT
T  C### ###TTTTTTTTTTT
T C #######TTTTBTTTTTT
T  K###  ##TTTTTTBTTTT
TTTT###  G#TTTTBTTTTTT
TTTTTTTTTTTTTTTTTTTTTT
TT#########TTT######TT
TTTTTT#TTTTTTT#TTTT#TT
TTTTTT#TTTTTTT######TT
TTTTTT#TTTTTTT#TTTTTTT
TTTTTT#TTTTTTT#TTTTTTT