TTTTTTTTTTTT
T@ TTTT####T
T   #######T
T B #######T
T   ##  TT#T
T B ###B T#T
T  C### ###T
T   #######T
T  K###  ##T
TTTT###  G#T
TTTTTTTTTTTT