TTTTTTTTTTTT
T@ TTTT####T
T B #######T
T B #######T
T B ##  TT#T
T B ###B T#T
T  C### ###T
T   #######T
T  K###  ##T
TTTT###  G#T
TTTTTTTTTTTT