TTTTTTTTTTTT
T@ TTTT####T
T B #######T
T B #######T
T B ##  K #T
T B ## B  #T
T  C### ###T
T   #######T
T   ###  ##T
TTTT###  G#T
TTTTTTTTTTTT