TTTTTTTTTTTT
T@ TTTT####T
T B #######T
T B #######T
T B ## KTT#T
T B ###B T#T
T  C### ###T
T B #######T
T   ###  ##T
TTTT###  G#T
TTTTTTTTTTTT