TTTTTTTTTTTTTTTTTTT
 @ TTTT#####    ##T
  B ########  K ##T
T B ###   ###B  ##T
T B ##  B ###   ##T
T B ## B#B###   ##T
T  C### ##########T
T BB####  ##   ###T
T B ##  B ##  BB##T
TTTT###BG####   ##T
TTTTTTTTTTTTTTTTTTT